###################
##      ####      #
## #### #     #  ##
##      ### #  ##B#
## # ##        ## #
## # ## ####      #
#  # #     # #### #
##  A  #####      #
###################