#####################
#A#     #           #
# # ### # # # ##### #
# #   # # # # #   # #
# ##### # # # # # # #
#           # # #   #
##### ####### # ##### 
#         #         B
#####################